{
    "1": [
        [ "b" ]
    ],
    "2": [
        [ "w", "w", "w", "w", "w", "w", "w" ],
        [ "w", "_", "_", "_", "_", "_", "w" ],
        [ "w", "_", "w", "w", "w", "_", "w" ],
        [ "w", "_", "w", "b", "w", "_", "w" ],
        [ "w", "_", "w", "w", "w", "_", "w" ],
        [ "w", "_", "_", "_", "_", "_", "w" ],
        [ "w", "w", "w", "w", "w", "w", "w" ]
    ]
}
